FFFFFFFFFFFFDDDDFFFFFFFFFFFFFF
FCWWWWWCWWWWDDDDWWWWWWWWWWWWWR
FSFFFFFSFFFFFFFFFSFFFFFFFFFFFS
FSFFFCoCWWRFCWWWWrFFCWWWWRFFFS
FSFFFSFSFFSFSFFFFFFFrFFFFSFFFS
FSFCWrFcWWrFSFFFFFFFFFFFFSFFFS
FSFSFFFFFFFFSFFFFFFFCWWFFSFFFS
FSFSFF1CWWWWrFFFFFFFSFFFFSFFFS
FSFSFFFSFFFFFFFFFFFFSFFFFSFFFS
FSFSFFFSFFFFFFFFCWWWrFFFFSFFFS
FSFSFFFSFFFFFFFFSF1F1FFFFSFFFS
FSFCWWWrFFFFFFFFSFFFFFFFFSFFFS
FSFSFFFFFFFFFFFFSF1FFFFFFSFFFS
FSFCWWWWWRFFFFFFSFFFFF1FFSFFFS
FSFSFFFFFSFFFFFFSFFF1FFFFSFFFS
FSFrFFFFFSFFFFFFSFFFFFFFFSFFFS
FSFF1FFFFSFFFFFFSFFFFF1FFSFFFS
FSFFFFFFFSFFFFFFSFFFFFFFFSFFFS
FSFCWWdWWrFFFFFFcWWWWWWWWrFFFS
FSFSFFFFFFFFFFFFFFFFFFFFFFFFFS
FSFSFFFFFFFFFFFFFFFFFFFFFFFFFS
FSFSFFFFFFFFFFFFFFFFFFFFFFFFFS
FWWWWWWWWWWWWWWWWWWWWWWWWWWWWrs