FFFFFFFFFFFFDDDDFFFFFFFFFFFFFF
FCWWWWWCWWWWDDDDWWWWWWWWWWWWWR
FSFFFFFSFFFFFFFFFFFFFFFFFFFFFS
FSFFFCoCWWRFCWWWWrFFCWWWWRFFFS
FSFFFSFSFFSFSFFFFFFFrFFFFSFFFS
FSFCWrFcWWrFSFFFFFFFFFFFFSFFFS
FSFSFFFFFFFFSFFFFFFFCWWFFSFFFS
FSFSFFFCWWWWrFFFFFFFSFFFFSFFFS
FSFSFFFSFFFFFFFFFFFFSFFFFSFFFS
FSFSFFFSFFFFFFFFCWWWrFFFFSFFFS
FSFSFFFSFFFFFFFFSFFFFFFFFSFFFS
FSFCWWWrFFFFFFFFSFFFFFFFFSFFFS
FSFSFFFFFFFFFFFFSFFFFFFFFSFFFS
FSFCWWWWWRFFFFFFSFFFFFFFFSFFFS
FSFSFFFFFSFFFFFFSFFFFFFFFSFFFS
FSFrFFFFFSFFFFFFSFFFFFFFFSFFFS
FSFFFFFFFSFFFFFFSFFFFFFFFSFFFS
FSFFFFFFFSFFFFFFSFFFFFFFFSFFFS
FSFCWWdWWrFFFFFFcWWWWWWWWrFFFS
FSFSFFFFFFFFFFFFFFFFFFFFFFFFFS
FSFSFFFFFFFFFFFFFFFFFFFFFFFFFS
FSFSFFFFFFFFFFFFFFFFFFFFFFFFFS
FWWWWWWWWWWWWWWWWWWWWWWWWWWWWrs